NO sprites/naturalbricks_hd_almostlight.xpm   
SO  sprites/naturalbricks_hd_almostlight.xpm
WE  sprites/naturalbricks_hd_verydark.xpm
EA  sprites/naturalbricks_hd_verydark.xpm
F   104,106,105
C   0,0,1

        1111111111111111111111111
        1000000000110000000000001
        1011000001110000000000001
        1001000000000000000000001
111111111011000001110000000000001   111111111111111
100000000000000001110111110111111   100000000000001
11110111111111011100000010001       100000000000001
111101111111110111010100100011111111100000000000001
110000001101010111000000100000000000000000000000001
100000000000000011000000100011111111100000000000001
10000000000000001101010010001111    100000000000001
10000000000000001101010010001011    100000000000001
111110000011101010111110110W0111  111111111111111
1111011111110101 101111010001111
11111111 1111111 111111111111
