EA  sprites/grey_bricks.xpm
WE  sprites/grey_bricks.xpm
NO  sprites/door.xpm
SO  sprites/door.xpm
F   104,106,105
C   40,177,214

111111111111111111
100000000000000S01
100000000000000001
100000000000000001
100000000000000001
100000001100000001
100000001100000001
100000000000000001
100000000000000001
100000001100000001
100000001100000001
100000000000000001
100000000000000001
111111111111111111