NO  sprites/naturalbricks_hd_almostlight.xpm
SO  sprites/naturalbricks_hd_almostlight.xpm
WE  sprites/naturalbricks_hd_verydark.xpm
EA  sprites/naturalbricks_hd_verydark.xpm
F   104,106,105
C   40,177,214

111111111111111111
100000000000000S01
100000000000000001
100000001100000001
100000000000000001
100000000000000001
100000001100000001
100000001100000001
111000000000000001
100000000000000001
100000001100000001
100000001100000001
100000000000001001
111000000000001001
100000100000001001
100001100000001001
100001100000001001
111111111111111111