NO  sprites/naturalbricks_hd_almostlight.xpm
SO  sprites/naturalbricks_hd_almostlight.xpm
WE  sprites/naturalbricks_hd_verydark.xpm
EA  sprites/naturalbricks_hd_verydark.xpm
F   104,106,105
C   40,177,214

11111111
10000001
10110001
10010001    111111
10010001    100N01
10000101    100001
10000001    111111
11111111
