NO  sprites/naturalbricks_hd_almostlight.xpm
SO  sprites/naturalbricks_hd_almostlight.xpm
WE  sprites/naturalbricks_hd_verydark.xpm
EA  sprites/naturalbricks_hd_verydark.xpm
F   104,106,105
C   40,177,214


        1111111111111111111111111
        1000000000110000000000001
        1001000001110000000000001
        1001000000000000000000001
111111111001000001110000000000001   111111111111111
1000000000000000011100111000111111  100000000000001
11110011111110011100000010001       100000000000001
111100111111100111010100100011111111100000000000001
110000001101000111000000100000000000000000000000001
110000001100000000000000000000000000000000000000001
1100000011000000000000000000000000S0000000000000001
110000001100010000000000110000000000000000000000001
110000001100010000000000000000000000000000000000001
110000001100010000000000000000000000000000000000001
100000000000000000000000000011111111100000000000001
10000000000000001101000010001       100000000000001
1100000111010111111100111000111     111111111111111
11111111 1111111 111111111111
