NO  sprites/naturalbricks_hd_almostlight.xpm
SO  sprites/naturalbricks_hd_almostlight.xpm
WE  sprites/naturalbricks_hd_verydark.xpm
EA  sprites/naturalbricks_hd_verydark.xpm
F   104,106,105
C   40,177,214


        1111111111111111111111111
        1000000000110000000000001
        1011000001110000000000001
        1001000000000000000000001
111111111011000001110000000000001   111111111111111
100000000000000001110111110111111   100000000000001
11110111111111011100000010001       100000000000001
111101111111110111010100100011111111100000000000001            11111             
110000001101010111000000100000000000000000000000001            10N01
100000000000000011000000100011111111100000000000001            11111
10000000000000001101010010001       100000000000001
1100000111010101111101111000111     111111111111111
11110111 1110101 101111010001
11111111 1111111 111111111111
