NO  sprites/naturalbricks_hd_almostlight.xpm
SO  sprites/rubiksS.xpm
WE  sprites/door.xpm
EA  sprites/psyche.xpm
F   222,184,135
C   255,248,247

1111111
1000001
100W001
1000001
1111111
