NO  sprites/rubiksN.xpm
F   222,184,135
C   255,248,247
SO  sprites/rubiksS.xpm
WE  sprites/rubiksW.xpm
EA  sprites/rubiksE.xpm


        1111111111111111111111111
        1000000000110000000000001
        1000000000110000000000001
        1001000001110000000000001
        1001000000000000000000001
        1001000000000000000000001
111111111001000001110000000000001   111111111111111
1000000000000000011100111000111111  100000000000001
1000000000000000011100111000111111  100000000000001
11110011111110011100000010001       100000000000001
111100111111100111000000100011111111100000000000001
110000001100000111000000100000000000000000000000001
110000001100000000000000000000000000000000000000001
110000001100000000000000000000000000000000000000001
1100E0001100010000000000110000000000000000000000001
110000001100010000000000000000000000000000000000001
110000001100010000000000000000000000000000000000001
100000000000000000000000000011111111100000000000001
10000000000000001101000010001       100000000000001
1100000111000111111100111000111     111111111111111
11111111 1111111 111111111111
